Enigma-3D
001 001 001 001 001 001 001 001 001 001 001 001 001 001 001 001 001 001 001 001
001 003 003 003 003 003 003 003 003 003 003 003 003 003 003 003 002 004 004 001
001 003 003 029 003 003 003 003 003 003 003 003 029 003 003 003 002 004 004 001
001 003 001 001 001 003 003 003 003 003 003 003 003 003 003 003 002 004 004 001
001 003 001 003 003 003 004 003 003 003 004 003 003 003 003 003 002 004 004 001
001 003 001 003 003 004 004 004 003 004 004 004 003 003 003 003 001 004 004 001
001 003 001 003 003 003 004 003 003 003 004 003 003 003 003 003 001 004 004 001
001 003 001 001 001 003 003 003 003 003 003 003 003 003 003 003 001 004 004 001
001 003 003 003 003 003 003 003 003 003 003 003 003 003 003 003 001 004 004 001
001 003 003 003 003 003 003 003 003 003 003 003 003 003 003 003 001 004 004 001
001 003 003 003 003 003 003 003 003 003 003 003 029 003 003 003 001 004 004 001
001 003 003 003 003 003 003 003 003 003 003 003 003 003 003 003 001 004 004 001
001 001 001 001 001 001 001 001 001 001 001 001 001 001 001 001 001 001 001 001
introduce 14 2 to 1 7
introduce 1 7 to 15 2
introduce 12 2 to 7 10
end

